1 1 1 1 1 1 1 1 1 0 1 1 1 1 1 1 1 1 1 1
1 1 1 1 1 1 1 1 1 0 1 1 1 1 1 1 1 1 1 1
1 1 1 1 1 6 1 1 1 0 1 1 1 1 1 1 1 1 1 1
1 1 1 1 1 1 1 1 1 0 1 1 1 1 1 1 1 1 1 1
1 1 1 1 1 1 1 1 1 0 1 1 6 1 1 0 5 0 1 1
1 1 1 1 0 4 0 1 1 0 1 1 1 1 1 1 1 1 1 1
1 1 1 1 1 1 1 1 0 2 3 1 1 1 1 1 1 1 1 1
1 0 1 6 1 1 1 1 1 1 1 1 1 1 1 1 1 1 6 1
1 0 1 1 1 1 1 1 1 1 0 4 0 1 1 1 1 1 1 1
1 4 1 1 1 1 1 1 5 1 1 1 1 1 1 1 0 5 0 1
1 1 1 1 1 1 1 1 1 1 1 1 1 1 1 1 1 1 1 1
